{
 {'*','*','*','*','*','*','*','*','*','*','*','*','*','*','*','*','*','*','*','*','*','*','*','*','*','*','*','*','*','*','*','*','*','*','*','*','*','*','*','*'},
 {'*',' ',' ',' ','*',' ',' ',' ',' ',' ',' ',' ',' ',' ',' ','*','*','*',' ',' ',' ',' ','*','*','*',' ',' ',' ',' ',' ',' ',' ',' ',' ',' ','*',' ',' ',' ','*'},
 {'*',' ','*',' ','*',' ','*','*','*',' ','*','*','*','*',' ',' ','*',' ',' ',' ',' ',' ',' ','*',' ',' ','*','*','*','*',' ','*','*','*',' ','*',' ','*',' ','*'},
 {'*',' ',' ',' ',' ',' ','*',' ',' ',' ','*','*',' ','*','*',' ',' ',' ','*','*','*','*',' ',' ',' ','*','*',' ','*','*',' ',' ',' ','*',' ',' ',' ',' ',' ','*'},
 {'*','*','*','*','*',' ','*',' ','*',' ','*',' ',' ',' ','*','*',' ','*','*','v',' ','*','*','*','*','*',' ',' ',' ','*',' ','*',' ','*',' ','*','*','*','*','*'},
 {'*',' ',' ',' ',' ',' ','*',' ',' ',' ',' ',' ','*',' ',' ',' ',' ',' ',' ',' ',' ',' ',' ',' ',' ',' ',' ','*',' ',' ',' ',' ',' ','*',' ',' ',' ',' ',' ','*'},
 {'*',' ','*','*',' ','*','*','*','*','*','*',' ','*','*','*','*','*','*','*','*','*','*','*','*','*','*','*','*',' ','*','*','*','*','*','*',' ','*','*',' ','*'},
 {'*',' ',' ',' ',' ',' ',' ',' ',' ',' ',' ',' ','*',' ',' ',' ',' ','*',' ',' ',' ',' ','*',' ',' ',' ',' ','*',' ',' ',' ',' ',' ',' ',' ',' ',' ',' ',' ','*'},
 {'*','*','*','*',' ','*','*','*','*','*','*','*',' ',' ','*',' ',' ',' ',' ',' ',' ',' ',' ',' ',' ','*',' ',' ','*','*','*','*','*','*','*',' ','*','*','*','*'},
 {'*',' ',' ',' ',' ',' ',' ',' ',' ',' ',' ',' ',' ',' ',' ','*',' ',' ',' ','*','*',' ',' ',' ','*',' ',' ',' ',' ',' ',' ',' ',' ',' ',' ',' ',' ',' ',' ','*'},
 {'*','*','*','*','*','*','*','*','*','*','*','*','*',' ',' ',' ','*',' ','*',' ',' ','*',' ','*',' ',' ',' ','*',' ','*','*','*','*','*','*','*','*','*','*','*'},
 {'*',' ',' ',' ',' ',' ',' ',' ',' ',' ',' ',' ',' ','*',' ',' ',' ','*',' ',' ',' ',' ','*',' ',' ',' ','*',' ',' ',' ',' ',' ',' ',' ',' ',' ',' ',' ',' ','*'},
 {'*',' ',' ',' ',' ',' ',' ',' ',' ',' ',' ',' ',' ',' ','*',' ',' ',' ',' ',' ',' ',' ',' ',' ',' ','*',' ',' ',' ',' ',' ',' ',' ',' ',' ',' ',' ',' ',' ','*'},
 {'*',' ',' ','*','*','*','*','*','*','*','*',' ',' ',' ',' ','*',' ',' ',' ','*','*',' ',' ',' ','*',' ',' ',' ','*','*','*','*','*','*','*','*','*',' ',' ','*'},
 {'*',' ',' ','*',' ',' ',' ',' ',' ',' ',' ','*',' ',' ',' ','*','*','*','*','*','*','*','*','*','*',' ',' ',' ',' ',' ',' ',' ',' ',' ',' ',' ',' ',' ',' ','*'},
 {'*',' ',' ','*',' ',' ',' ',' ',' ',' ',' ',' ','*',' ',' ',' ',' ',' ',' ',' ',' ',' ',' ',' ',' ',' ',' ',' ',' ',' ',' ',' ',' ',' ',' ',' ',' ',' ',' ','*'},
 {'*',' ',' ','*',' ',' ','*',' ',' ','*',' ',' ','*',' ',' ',' ',' ',' ',' ',' ',' ',' ',' ',' ',' ',' ',' ','*','*','*','*','*','*','*','*','*','*','*','*','*'},
 {'*',' ',' ','*',' ',' ','*',' ',' ','*',' ',' ','*','*','*','*','*','*','*','*','*','*','*','*','*',' ',' ','*',' ',' ',' ',' ',' ',' ',' ',' ',' ',' ',' ','*'},
 {'*',' ',' ','*','*','*','*',' ',' ','*','*','*','*','*','*','*','*','*','*','*','*','*','*','*','*',' ',' ','*',' ',' ',' ',' ',' ',' ',' ',' ',' ',' ',' ','*'},
 {'*',' ',' ',' ',' ',' ',' ',' ',' ',' ',' ',' ',' ',' ',' ',' ',' ',' ',' ',' ',' ',' ',' ',' ',' ',' ',' ','*',' ',' ','*','*','*','*',' ',' ','*','*','*','*'},
 {'*',' ',' ',' ',' ',' ',' ',' ',' ',' ',' ',' ',' ',' ',' ',' ',' ',' ',' ',' ',' ',' ',' ',' ',' ',' ',' ','*',' ',' ','*',' ',' ','*',' ',' ','*',' ',' ','*'},
 {'*',' ',' ','*','*','*','*',' ',' ','*','*','*','*','*','*','*','*','*','*','*','*','*','*','*','*',' ',' ','*',' ',' ','*',' ',' ','*',' ',' ','*',' ',' ','*'},
 {'*',' ',' ','*',' ',' ',' ',' ',' ','*','*',' ',' ',' ',' ',' ',' ',' ',' ',' ',' ',' ',' ','*','*',' ',' ',' ',' ',' ','*',' ',' ',' ',' ',' ',' ',' ',' ','*'},
 {'*',' ',' ','*',' ',' ',' ',' ',' ','*',' ',' ','*',' ','*',' ','*','*','*','*','*','*',' ',' ','*',' ',' ',' ',' ',' ','*',' ',' ',' ',' ',' ',' ',' ',' ','*'},
 {'*',' ',' ','*','*','*','*',' ',' ','*',' ','*','*',' ','*',' ',' ',' ',' ',' ',' ','*','*',' ','*',' ',' ','*','*','*','*',' ',' ','*',' ',' ','*','*','*','*'},
 {'*',' ',' ',' ',' ',' ',' ',' ',' ','*',' ',' ','*',' ','*','*','*','*','*','*',' ','*',' ',' ','*',' ',' ',' ',' ',' ',' ',' ',' ','*',' ',' ',' ',' ',' ','*'},
 {'*',' ',' ',' ',' ',' ',' ',' ',' ','*','*',' ',' ',' ',' ',' ',' ',' ',' ',' ',' ',' ',' ','*','*',' ',' ',' ',' ',' ',' ',' ',' ','*',' ',' ',' ',' ',' ','*'},
 {'*',' ',' ','*','*','*','*','*','*','*','*','*','*','*','*',' ',' ','*','*','*','*','*','*','*','*','*','*','*','*','*','*','*','*','*','*','*','*',' ',' ','*'},
 {'*',' ',' ','*',' ',' ',' ',' ',' ',' ',' ',' ',' ',' ',' ',' ',' ',' ',' ',' ',' ',' ',' ',' ',' ',' ',' ',' ',' ',' ',' ',' ',' ',' ',' ',' ',' ',' ',' ','*'},
 {'*',' ',' ','*',' ',' ',' ',' ',' ',' ',' ',' ',' ',' ',' ',' ',' ',' ',' ',' ',' ',' ',' ',' ',' ',' ',' ',' ',' ',' ',' ',' ',' ',' ',' ',' ',' ',' ',' ','*'},
 {'*',' ',' ','*',' ',' ','*','*','*','*','*','*','*','*','*','*','*','*','*','*','*','*','*','*','*','*','*','*','*','*','*','*','*',' ',' ','*','*','*','*','*'},
 {'*',' ',' ','*',' ',' ','*','o',' ','*',' ',' ',' ',' ',' ',' ',' ',' ',' ',' ',' ',' ',' ',' ',' ',' ',' ',' ',' ',' ',' ',' ','*',' ',' ','*',' ',' ',' ','*'},
 {'*',' ',' ','*',' ',' ','*','*',' ',' ',' ','*','*','*',' ',' ','*','*',' ','*','*','*',' ',' ','*',' ',' ','*','*',' ','*',' ','*',' ',' ',' ',' ','*',' ','*'},
 {'*',' ',' ',' ',' ',' ',' ','*',' ','*',' ',' ','*',' ',' ','*','*',' ',' ','*',' ',' ',' ','*','*','*',' ','*','*',' ','*',' ','*',' ',' ','*',' ','*',' ','*'},
 {'*',' ',' ',' ',' ',' ',' ','*',' ','*','*',' ',' ',' ',' ',' ',' ',' ',' ',' ',' ',' ',' ',' ',' ',' ',' ',' ',' ',' ',' ',' ','*',' ',' ','*',' ',' ',' ','*'},
 {'*','*',' ','*','*',' ',' ','*','*','*','*','*','*','*','*','*','*','*','*','*',' ','*','*','*','*','*','*','*','*','*','*','*','*',' ',' ','*','*',' ','*','*'},
 {'*',' ',' ',' ','*',' ',' ',' ',' ',' ',' ',' ',' ',' ',' ',' ',' ',' ',' ',' ',' ',' ',' ',' ',' ',' ',' ',' ',' ',' ',' ',' ',' ',' ',' ','*',' ',' ',' ','*'},
 {'*',' ','*',' ','*',' ',' ',' ',' ',' ',' ',' ',' ',' ',' ',' ',' ',' ',' ',' ',' ',' ',' ',' ',' ',' ',' ',' ',' ',' ',' ',' ',' ',' ',' ','*',' ','*',' ','*'},
 {'*',' ',' ',' ','*',' ',' ',' ',' ',' ',' ',' ',' ',' ',' ',' ',' ',' ',' ',' ',' ',' ',' ',' ',' ',' ',' ',' ',' ',' ',' ',' ',' ',' ',' ','*',' ',' ',' ','*'},
 {'*','*','*','*','*','*','*','*','*','*','*','*','*','*','*','*','*','*','*','*','*','*','*','*','*','*','*','*','*','*','*','*','*','*','*','*','*','*','*','*'}
};

