{{'*','*','*','*','*','*','*','*','*','*','*','*','*','*','*','*','*','*','*','*','*','*','*','*','*','*','*','*','*','*','*','*','*','*','*','*','*','*','*','*'},
 {'*','V','*',' ',' ',' ',' ',' ','*','*',' ',' ',' ','*','*','*',' ','*','*','*','*','*',' ',' ',' ',' ','*',' ','*',' ','*',' ',' ',' ','*',' ',' ',' ','<','*'},
 {'*',' ','*',' ','*',' ','*',' ',' ','*',' ','*',' ',' ','*',' ',' ',' ',' ',' ',' ','*',' ','*','*',' ',' ',' ',' ',' ','*',' ','*',' ','*',' ','*','O','*','*'},
 {'*',' ','*',' ','*',' ','*','*',' ','*','*','*','*',' ','*',' ','*',' ','*','*',' ','*',' ','*',' ',' ','*',' ','*',' ',' ',' ','*','*','*',' ','*','*','*','*'},
 {'*',' ','*',' ','*',' ',' ','*',' ',' ',' ',' ',' ',' ','*',' ','*','*','*',' ',' ','*',' ','*','*','*','*','*','*',' ','*',' ',' ',' ','*',' ',' ',' ',' ','*'},
 {'*',' ',' ',' ','*','*',' ','*',' ','*','*',' ','*','*','*','*','*',' ',' ',' ','*','*',' ','*',' ',' ',' ','*','*',' ','*',' ','*',' ','*','*','*','*',' ','*'},
 {'*',' ','*',' ',' ','*','*','*',' ','*',' ',' ','*',' ',' ',' ',' ',' ','*',' ','*',' ',' ',' ',' ','*',' ',' ','*','*','*','*','*',' ',' ',' ',' ','*',' ','*'},
 {'*',' ','*','*',' ',' ',' ',' ',' ','*',' ','*','*','*',' ','*','*',' ','*',' ',' ',' ','*','*','*','*','*',' ','*',' ',' ',' ','*','*',' ','*',' ','*',' ','*'},
 {'*',' ','*',' ',' ','*',' ','*',' ','*',' ',' ',' ','*',' ',' ','*',' ','*','*',' ','*','*','*',' ','*','*',' ',' ',' ','*',' ',' ','*','*','*','*','*',' ','*'},
 {'*',' ','*','*','*','*',' ','*',' ','*','*','*',' ','*','*',' ','*',' ',' ','*',' ',' ',' ',' ',' ',' ','*','*','*','*','*','*',' ',' ','*',' ','*','*',' ','*'},
 {'*',' ',' ','*',' ','*',' ',' ',' ','*',' ',' ',' ','*',' ',' ','*','*',' ',' ',' ','*','*',' ','*',' ','*',' ','*',' ','*','*','*',' ','*',' ',' ','*',' ','*'},
 {'*','*',' ','*',' ','*',' ','*','*','*','*',' ','*','*','*',' ',' ','*','*','*',' ','*','*',' ','*',' ',' ',' ',' ',' ',' ',' ','*',' ','*',' ','*','*',' ','*'},
 {'*',' ',' ',' ',' ','*',' ',' ',' ',' ','*',' ',' ',' ','*','*',' ',' ',' ','*',' ','*','*',' ','*','*','*','*',' ','*','*',' ','*',' ','*',' ',' ',' ',' ','*'},
 {'*','*',' ','*',' ','*','*','*','*',' ','*','*','*',' ',' ','*','*','*',' ','*',' ','*',' ',' ','*',' ','*',' ',' ','*',' ',' ','*',' ','*',' ','*','*',' ','*'},
 {'*',' ',' ','*',' ',' ',' ',' ','*',' ',' ',' ','*','*',' ',' ',' ','*',' ','*',' ','*',' ','*','*',' ',' ',' ',' ',' ',' ','*','*',' ','*',' ',' ','*',' ','*'},
 {'*','*','*','*','*','*','*',' ','*',' ','*',' ',' ','*',' ','*',' ',' ',' ','*',' ','*',' ',' ',' ',' ','*',' ','*','*',' ',' ','*',' ',' ',' ',' ','*',' ','*'},
 {'*',' ',' ',' ',' ',' ','*',' ','*',' ','*','*',' ','*','*','*','*','*','*','*','*','*','*','*','*','*','*',' ',' ','*','*',' ','*',' ','*',' ','*','*','*','*'},
 {'*',' ','*','*','*',' ','*',' ','*',' ',' ','*',' ','*',' ',' ',' ',' ',' ',' ',' ',' ',' ',' ',' ',' ','*',' ','*','*',' ',' ','*',' ','*',' ',' ',' ',' ','*'},
 {'*',' ','*',' ','*',' ','*',' ','*','*',' ','*',' ','*',' ','*','*',' ','*','*',' ','*',' ','*','*',' ','*','*','*','*',' ','*','*',' ','*','*','*','*',' ','*'},
 {'*',' ','*',' ','*',' ','*',' ',' ','*',' ','*','*','*',' ','*',' ',' ',' ','*',' ',' ',' ',' ',' ',' ',' ',' ',' ',' ',' ','*',' ',' ',' ','*',' ',' ',' ','*'},
 {'*',' ','*',' ','*',' ','*','*',' ','*',' ',' ',' ',' ',' ','*',' ','*',' ','*','*','*','*',' ','*','*','*','*','*','*',' ','*',' ','*',' ','*',' ','*','*','*'},
 {'*',' ',' ',' ','*',' ',' ',' ',' ','*','*','*','*','*',' ','*','*','*',' ',' ',' ',' ',' ',' ',' ',' ',' ',' ','*',' ',' ','*',' ',' ',' ','*',' ',' ',' ','*'},
 {'*',' ','*',' ','*','*','*','*',' ','*',' ','*',' ','*',' ',' ',' ','*','*',' ','*',' ','*',' ','*','*','*',' ','*','*',' ',' ',' ','*','*','*',' ','*',' ','*'},
 {'*',' ','*',' ',' ',' ',' ',' ',' ','*',' ',' ',' ','*',' ','*',' ',' ','*',' ','*','*','*',' ',' ',' ','*',' ',' ','*','*','*',' ','*',' ',' ',' ','*',' ','*'},
 {'*','*','*','*','*',' ','*','*',' ','*','*','*',' ','*',' ','*','*',' ','*',' ','*',' ','*','*','*','*','*','*',' ',' ','*',' ',' ',' ',' ','*',' ','*',' ','*'},
 {'*',' ',' ',' ','*',' ',' ','*',' ',' ',' ','*',' ',' ',' ','*',' ',' ',' ',' ','*',' ',' ',' ',' ',' ',' ','*','*',' ','*','*',' ','*','*','*','*','*','*','*'},
 {'*',' ','*',' ','*','*','*','*','*','*',' ','*','*','*','*','*','*','*','*','*','*','*','*','*','*','*',' ',' ',' ',' ',' ','*','*','*',' ',' ',' ',' ',' ','*'},
 {'*',' ','*',' ',' ',' ',' ',' ',' ',' ',' ',' ',' ',' ',' ','*',' ',' ',' ',' ',' ',' ',' ',' ',' ','*','*',' ','*',' ','*','*',' ',' ',' ','*','*','*',' ','*'},
 {'*',' ','*',' ','*',' ','*','*','*','*',' ','*','*','*',' ','*',' ','*','*','*','*','*','*','*',' ','*',' ',' ','*','*','*',' ',' ','*',' ','*','*',' ',' ','*'},
 {'*',' ',' ',' ','*',' ','*',' ',' ',' ',' ','*',' ',' ',' ','*',' ','*',' ',' ',' ',' ',' ','*',' ','*',' ','*','*',' ',' ',' ','*','*',' ',' ','*',' ','*','*'},
 {'*','*','*','*','*',' ','*',' ','*','*',' ','*','*','*','*',' ',' ','*',' ','*','*','*',' ','*',' ','*',' ','*',' ',' ','*',' ',' ','*','*',' ','*',' ',' ','*'},
 {'*','*',' ',' ',' ',' ','*',' ','*',' ',' ',' ',' ','*','*',' ','*','*',' ','*','*','*',' ','*',' ','*',' ','*','*',' ','*','*',' ',' ','*',' ','*',' ','*','*'},
 {'*',' ',' ','*','*',' ','*',' ','*',' ','*','*',' ','*',' ',' ',' ',' ',' ','*','*','*',' ','*',' ',' ',' ',' ','*',' ','*','*','*',' ',' ',' ','*',' ',' ','*'},
 {'*',' ','*','*',' ',' ','*',' ','*',' ','*',' ',' ','*','*',' ','*','*',' ','*','*','*',' ','*',' ','*','*',' ','*',' ','*',' ','*','*',' ','*','*','*',' ','*'},
 {'*',' ',' ',' ',' ',' ','*',' ','*',' ','*',' ',' ',' ',' ',' ',' ','*',' ',' ',' ',' ',' ','*',' ','*',' ',' ',' ',' ',' ',' ',' ',' ',' ','*',' ',' ',' ','*'},
 {'*','*','*','*','*',' ','*',' ','*',' ','*','*','*','*','*','*',' ','*','*','*','*','*','*','*',' ','*',' ','*','*',' ','*',' ','*','*',' ','*',' ','*','*','*'},
 {'*',' ',' ',' ','*',' ','*',' ',' ',' ',' ',' ','*',' ',' ',' ',' ',' ',' ',' ',' ',' ',' ',' ',' ','*',' ',' ',' ',' ','*',' ',' ','*',' ','*',' ',' ',' ','*'},
 {'*',' ','*',' ','*',' ','*',' ','*','*','*',' ','*','*','*','*','*',' ','*','*','*','*','*','*',' ','*','*','*','*','*','*','*',' ','*','*','*','*','*',' ','*'},
 {'*','^','*',' ',' ',' ','*',' ','*',' ',' ',' ','*',' ',' ',' ',' ',' ',' ',' ',' ',' ',' ','*',' ',' ',' ',' ',' ',' ',' ',' ',' ',' ',' ',' ',' ',' ','<','*'},
 {'*','*','*','*','*','*','*','*','*','*','*','*','*','*','*','*','*','*','*','*','*','*','*','*','*','*','*','*','*','*','*','*','*','*','*','*','*','*','*','*'}};

