{{'*','*','*','*','*','*','*','*','*','*','*','*','*','*','*','*','*','*','*','*','*','*','*','*','*','*','*','*','*','*','*','*','*','*','*','*','*','*','*','*'},
    {'*','V',' ',' ',' ',' ',' ',' ',' ',' ',' ',' ',' ',' ',' ',' ',' ',' ',' ',' ',' ',' ',' ',' ',' ',' ',' ',' ',' ',' ',' ',' ',' ',' ',' ',' ',' ',' ','^','*'},
    {'*',' ','*',' ',' ','*',' ',' ',' ','*',' ',' ',' ',' ',' ','*',' ',' ','*',' ',' ',' ',' ','*',' ',' ',' ',' ','*',' ',' ',' ',' ','*',' ','*',' ',' ',' ','*'},
    {'*',' ','*',' ',' ','*',' ',' ',' ','*',' ',' ',' ',' ',' ','*',' ',' ','*',' ',' ',' ',' ','*',' ',' ',' ',' ','*',' ',' ',' ',' ','*',' ','*',' ',' ',' ','*'},
    {'*',' ','*',' ',' ','*',' ',' ',' ','*',' ',' ',' ',' ',' ','*',' ',' ','*',' ',' ',' ',' ','*',' ',' ',' ',' ','*',' ',' ',' ',' ','*',' ','*',' ',' ',' ','*'},
    {'*',' ','*',' ',' ','*',' ',' ',' ','*',' ',' ',' ',' ',' ','*',' ',' ','*',' ',' ',' ',' ','*',' ',' ',' ',' ','*',' ',' ',' ',' ','*',' ','*',' ',' ',' ','*'},
    {'*',' ','*',' ',' ','*',' ',' ',' ','*',' ',' ',' ',' ',' ','*',' ',' ','*',' ',' ',' ',' ','*',' ',' ',' ',' ','*',' ',' ',' ',' ','*',' ','*',' ',' ',' ','*'},
    {'*',' ','*',' ',' ','*',' ',' ',' ','*',' ',' ',' ',' ',' ','*',' ',' ','*',' ',' ',' ',' ','*',' ',' ',' ',' ','*',' ',' ',' ',' ','*',' ','*',' ',' ',' ','*'},
    {'*',' ','*',' ',' ','*',' ',' ',' ','*',' ',' ',' ',' ',' ','*',' ',' ','*',' ',' ',' ',' ','*',' ',' ',' ',' ','*',' ',' ',' ',' ','*',' ','*',' ',' ',' ','*'},
    {'*',' ','*',' ',' ','*',' ',' ',' ','*',' ',' ',' ',' ',' ','*',' ',' ','*',' ',' ',' ',' ','*',' ',' ',' ',' ','*',' ',' ',' ',' ','*',' ','*',' ',' ',' ','*'},
    {'*',' ','*',' ',' ','*',' ',' ',' ','*',' ',' ',' ',' ',' ','*',' ',' ','*',' ',' ',' ',' ','*',' ',' ',' ',' ','*',' ',' ',' ',' ','*',' ','*',' ',' ',' ','*'},
    {'*',' ','*',' ',' ','*',' ',' ',' ','*',' ',' ',' ',' ',' ','*',' ',' ','*',' ',' ',' ',' ','*',' ',' ',' ',' ','*',' ',' ',' ',' ','*',' ','*',' ',' ',' ','*'},
    {'*',' ','*',' ',' ','*',' ',' ',' ','*',' ',' ',' ',' ',' ','*',' ',' ','*',' ',' ',' ',' ','*',' ',' ',' ',' ','*',' ',' ',' ',' ','*',' ','*',' ',' ',' ','*'},
    {'*',' ','*',' ',' ','*',' ',' ',' ','*',' ',' ',' ',' ',' ','*',' ',' ','*',' ',' ',' ',' ','*',' ',' ',' ',' ','*',' ',' ',' ',' ','*',' ','*',' ',' ',' ','*'},
    {'*',' ','*',' ',' ','*',' ',' ',' ','*',' ',' ',' ',' ',' ','*',' ',' ','*',' ',' ',' ',' ','*',' ',' ',' ',' ','*',' ',' ',' ',' ','*',' ','*',' ',' ',' ','*'},
    {'*',' ','*',' ',' ','*',' ',' ',' ','*',' ',' ',' ',' ',' ','*',' ',' ','*',' ',' ',' ',' ','*',' ',' ',' ',' ','*',' ',' ',' ',' ','*',' ','*',' ',' ',' ','*'},
    {'*',' ','*',' ',' ','*',' ',' ',' ','*',' ',' ',' ',' ',' ','*',' ',' ','*',' ',' ',' ',' ','*',' ',' ',' ',' ','*',' ',' ',' ',' ','*',' ','*',' ',' ',' ','*'},
    {'*',' ','*',' ',' ','*',' ',' ',' ','*',' ',' ',' ',' ',' ','*',' ',' ','*',' ',' ',' ',' ','*',' ',' ',' ',' ','*',' ',' ',' ',' ','*',' ','*',' ',' ',' ','*'},
    {'*',' ','*',' ',' ','*',' ',' ',' ','*',' ',' ',' ',' ',' ','*',' ',' ','*',' ',' ',' ',' ','*',' ',' ',' ',' ','*',' ',' ',' ',' ','*',' ','*',' ',' ',' ','*'},
    {'*',' ','*',' ',' ','*',' ',' ',' ','*',' ',' ',' ',' ',' ','*',' ',' ','*',' ',' ',' ',' ','*',' ',' ',' ',' ','*',' ',' ',' ',' ','*',' ','*',' ',' ',' ','*'},
    {'*',' ',' ',' ',' ',' ',' ',' ',' ',' ',' ',' ',' ',' ',' ',' ',' ',' ',' ',' ',' ',' ',' ',' ',' ',' ',' ',' ',' ',' ',' ',' ',' ',' ',' ',' ',' ',' ',' ','*'},
    {'*',' ','*',' ',' ','*',' ',' ',' ','*',' ',' ',' ',' ',' ','*',' ',' ','*',' ',' ',' ',' ','*',' ',' ',' ',' ','*',' ',' ',' ',' ','*',' ','*',' ',' ',' ','*'},
    {'*',' ','*',' ',' ','*',' ',' ',' ','*',' ',' ',' ',' ',' ','*',' ',' ','*',' ',' ',' ',' ','*',' ',' ',' ',' ','*',' ',' ',' ',' ','*',' ','*',' ',' ',' ','*'},
    {'*',' ','*',' ',' ','*',' ',' ',' ','*',' ',' ',' ',' ',' ','*',' ',' ','*','O',' ',' ',' ','*',' ',' ',' ',' ','*',' ',' ',' ',' ','*',' ','*',' ',' ',' ','*'},
    {'*',' ','*',' ',' ','*',' ',' ',' ','*',' ',' ',' ',' ',' ','*',' ',' ','*',' ',' ',' ',' ','*',' ',' ',' ',' ','*',' ',' ',' ',' ','*',' ','*',' ',' ',' ','*'},
    {'*',' ','*',' ',' ','*',' ',' ',' ','*',' ',' ',' ',' ',' ','*',' ',' ','*',' ',' ',' ',' ','*',' ',' ',' ',' ','*',' ',' ',' ',' ','*',' ','*',' ',' ',' ','*'},
    {'*',' ','*',' ',' ','*',' ',' ',' ','*',' ',' ',' ',' ',' ','*',' ',' ','*',' ',' ',' ',' ','*',' ',' ',' ',' ','*',' ',' ',' ',' ','*',' ','*',' ',' ',' ','*'},
    {'*',' ','*',' ',' ','*',' ',' ',' ','*',' ',' ',' ',' ',' ','*',' ',' ','*',' ',' ',' ',' ','*',' ',' ',' ',' ','*',' ',' ',' ',' ','*',' ','*',' ',' ',' ','*'},
    {'*',' ','*',' ',' ','*',' ',' ',' ','*',' ',' ',' ',' ',' ','*',' ',' ','*',' ',' ',' ',' ','*',' ',' ',' ',' ','*',' ',' ',' ',' ','*',' ','*',' ',' ',' ','*'},
    {'*',' ','*',' ',' ','*',' ',' ',' ','*',' ',' ',' ',' ',' ','*',' ',' ','*',' ',' ',' ',' ','*',' ',' ',' ',' ','*',' ',' ',' ',' ','*',' ','*',' ',' ',' ','*'},
    {'*',' ','*',' ',' ','*',' ',' ',' ','*',' ',' ',' ',' ',' ','*',' ',' ','*',' ',' ',' ',' ','*',' ',' ',' ',' ','*',' ',' ',' ',' ','*',' ','*',' ',' ',' ','*'},
    {'*',' ','*',' ',' ','*',' ',' ',' ','*',' ',' ',' ',' ',' ','*',' ',' ','*',' ',' ',' ',' ','*',' ',' ',' ',' ','*',' ',' ',' ',' ','*',' ','*',' ',' ',' ','*'},
    {'*',' ','*',' ',' ','*',' ',' ',' ','*',' ',' ',' ',' ',' ','*',' ',' ','*',' ',' ',' ',' ','*',' ',' ',' ',' ','*',' ',' ',' ',' ','*',' ','*',' ',' ',' ','*'},
    {'*',' ','*',' ',' ','*',' ',' ',' ','*',' ',' ',' ',' ',' ','*',' ',' ','*',' ',' ',' ',' ','*',' ',' ',' ',' ','*',' ',' ',' ',' ','*',' ','*',' ',' ',' ','*'},
    {'*',' ','*',' ',' ','*',' ',' ',' ','*',' ',' ',' ',' ',' ','*',' ',' ','*',' ',' ',' ',' ','*',' ',' ',' ',' ','*',' ',' ',' ',' ','*',' ','*',' ',' ',' ','*'},
    {'*',' ','*',' ',' ','*',' ',' ',' ','*',' ',' ',' ',' ',' ','*',' ',' ','*',' ',' ',' ',' ','*',' ',' ',' ',' ','*',' ',' ',' ',' ','*',' ','*',' ',' ',' ','*'},
    {'*',' ','*',' ',' ','*',' ',' ',' ','*',' ',' ',' ',' ',' ','*',' ',' ','*',' ',' ',' ',' ','*',' ',' ',' ',' ','*',' ',' ',' ',' ','*',' ','*',' ',' ',' ','*'},
    {'*',' ','*',' ',' ','*',' ',' ',' ','*',' ',' ',' ',' ',' ','*',' ',' ','*',' ',' ',' ',' ','*',' ',' ',' ',' ','*',' ',' ',' ',' ','*',' ','*',' ',' ',' ','*'},
    {'*','>',' ',' ',' ',' ',' ',' ',' ',' ',' ',' ',' ',' ',' ',' ',' ',' ',' ',' ',' ',' ',' ',' ',' ',' ',' ',' ',' ',' ',' ',' ',' ',' ',' ',' ',' ',' ','<','*'},
    {'*','*','*','*','*','*','*','*','*','*','*','*','*','*','*','*','*','*','*','*','*','*','*','*','*','*','*','*','*','*','*','*','*','*','*','*','*','*','*','*'}};