{{'*','*','*','*','*','*','*','*','*','*','*','*','*','*','*','*','*','*','*','*','*','*','*','*','*','*','*','*','*','*','*','*','*','*','*','*','*','*','*','*'},
 {'*',' ',' ',' ',' ',' ',' ',' ',' ','*',' ',' ',' ','*',' ',' ',' ','*','V','*',' ',' ','*',' ',' ',' ','*',' ',' ',' ','*',' ',' ',' ',' ',' ',' ',' ',' ','*'},
 {'*',' ',' ','*','*','*','*','*','*','*','*','*','*','*','*','*','*','*',' ','*','*','*','*','*','*','*','*','*','*','*','*','*','*','*','*','*','*','*','*','*'},
 {'*',' ',' ',' ','*',' ','^',' ',' ',' ',' ',' ',' ',' ',' ',' ',' ',' ','O',' ',' ',' ',' ',' ',' ',' ',' ',' ',' ',' ',' ',' ',' ',' ',' ',' ',' ',' ','V','*'},
 {'*',' ',' ',' ','*','*','*','*','*','*','*','*','*','*','*','*','*','*',' ','*','*','*','*','*','*','*','*','*','*','*','*','*','*','*','*','*','*','*','*','*'},
 {'*',' ',' ',' ','*',' ',' ',' ',' ','*',' ','*',' ',' ',' ',' ',' ','*',' ','*','*',' ',' ',' ',' ',' ',' ',' ','*',' ','*',' ',' ',' ',' ','*',' ','*',' ','*'},
 {'*',' ',' ',' ','*',' ','*','*','*','*',' ','*',' ','*',' ','*','*','*',' ','*',' ',' ','*','*','*',' ','*',' ','*',' ','*','*','*','*',' ','*',' ',' ',' ','*'},
 {'*',' ',' ','*','*',' ','*',' ',' ',' ',' ',' ',' ','*',' ',' ','*','*',' ','*','*',' ',' ','*',' ',' ','*',' ',' ',' ',' ',' ',' ','*',' ','*','*','*',' ','*'},
 {'*',' ',' ',' ',' ',' ','*',' ','*','*','*','*','*','*','*',' ','*','*',' ','*','*','*',' ','*',' ','*','*','*','*','*','*','*',' ','*',' ',' ',' ',' ',' ','*'},
 {'*',' ',' ',' ','*','*','*',' ','*',' ',' ',' ',' ',' ',' ',' ','*','*',' ','*',' ',' ',' ','*',' ',' ',' ',' ',' ',' ',' ','*',' ','*','*','*',' ','*','*','*'},
 {'*',' ',' ',' ',' ',' ',' ',' ','*',' ','*','*','*',' ','*',' ','*','*',' ','*','*','*','*','*',' ','*',' ','*','*','*',' ','*',' ',' ',' ',' ',' ',' ',' ','*'},
 {'*',' ',' ','*','*','*','*',' ','*',' ','*',' ',' ',' ','*',' ',' ','*','^','*',' ',' ',' ',' ',' ','*',' ',' ',' ','*',' ','*',' ','*','*','*','*','*',' ','*'},
 {'*',' ',' ',' ',' ',' ',' ',' ','*',' ','*',' ','*',' ','*',' ','*','*','*','*','*',' ','*','*',' ','*',' ','*',' ','*',' ','*',' ',' ',' ',' ',' ',' ',' ','*'},
 {'*',' ',' ',' ','*',' ','*','*','*',' ',' ',' ',' ',' ',' ',' ','*',' ',' ',' ','*',' ',' ','*',' ',' ',' ',' ',' ',' ',' ','*','*','*',' ','*',' ','*','*','*'},
 {'*',' ',' ',' ','*',' ',' ',' ','*',' ','*','*','*',' ','*','*','*',' ','*','*','*',' ','*','*','*','*',' ','*','*','*',' ','*',' ',' ',' ','*',' ',' ',' ','*'},
 {'*',' ','*','*','*',' ','*',' ',' ',' ',' ',' ',' ',' ','*',' ',' ',' ',' ','*',' ',' ',' ',' ',' ','*',' ',' ',' ',' ',' ',' ',' ','*',' ','*','*','*',' ','*'},
 {'*',' ',' ',' ','*',' ','*','*','*','*','*',' ','*','*','*',' ','*','*',' ','*','*','*','*','*',' ','*','*','*',' ','*','*','*','*','*',' ','*',' ',' ',' ','*'},
 {'*','*','*',' ',' ',' ','*',' ',' ',' ','*',' ','*',' ','*',' ','*',' ',' ',' ',' ',' ',' ','*',' ',' ',' ',' ',' ','*',' ',' ',' ','*',' ',' ',' ','*','*','*'},
 {'*',' ','*',' ','*',' ',' ',' ','*',' ','*',' ',' ',' ',' ',' ','*',' ','*',' ','*','*',' ',' ',' ','*',' ','*',' ','*',' ','*',' ',' ',' ','*',' ','*',' ','*'},
 {'*',' ',' ',' ','*','*',' ','*','*',' ','*',' ','*','*','*',' ','*',' ','*',' ','O','*',' ','*','*','*',' ','*',' ','*',' ','*','*',' ','*','*',' ',' ',' ','*'},
 {'*',' ',' ',' ','*','*',' ','*','*',' ','*',' ','*',' ','*','*','*',' ','*',' ',' ','*',' ','*',' ','*','*','*',' ','*',' ','*','*',' ','*','*',' ',' ',' ','*'},
 {'*',' ','*',' ','*',' ',' ',' ','*',' ','*',' ','*',' ','*',' ',' ',' ','*','*',' ','*',' ','*',' ',' ',' ',' ',' ','*',' ','*',' ',' ',' ','*',' ','*',' ','*'},
 {'*','*','*',' ',' ',' ','*',' ',' ',' ','*',' ',' ',' ',' ',' ','*',' ',' ',' ',' ',' ',' ','*',' ','*',' ','*',' ','*',' ',' ',' ','*',' ',' ',' ','*','*','*'},
 {'*',' ',' ',' ','*',' ','*','*','*','*','*',' ','*','*','*',' ','*','*','*','*','*',' ','*','*',' ','*','*','*',' ','*','*','*','*','*',' ','*',' ',' ',' ','*'},
 {'*',' ','*','*','*',' ','*',' ',' ',' ',' ',' ',' ',' ','*',' ',' ',' ',' ',' ','*',' ',' ',' ',' ','*',' ',' ',' ',' ',' ',' ',' ','*',' ','*','*',' ',' ','*'},
 {'*',' ',' ',' ','*',' ',' ',' ','*',' ','*','*','*',' ','*','*','*','*',' ','*','*','*',' ','*','*','*',' ','*','*','*',' ','*',' ',' ',' ','*',' ',' ',' ','*'},
 {'*','*','*',' ','*',' ','*','*','*',' ',' ',' ',' ',' ',' ',' ','*',' ',' ','*',' ',' ',' ','*',' ',' ',' ',' ',' ',' ',' ','*','*','*',' ','*',' ','*','*','*'},
 {'*',' ',' ',' ',' ',' ',' ',' ','*',' ','*',' ','*',' ','*',' ','*','*',' ','*','*','*',' ','*',' ','*',' ','*',' ','*',' ','*',' ',' ',' ',' ',' ',' ',' ','*'},
 {'*',' ','*','*','*','*','*',' ','*',' ','*',' ',' ',' ','*',' ',' ',' ',' ',' ',' ',' ',' ',' ',' ','*',' ',' ',' ','*',' ','*',' ','*','*','*','*','*',' ','*'},
 {'*',' ',' ',' ',' ',' ',' ',' ','*',' ','*','*','*',' ','*',' ','*','*','*','*','*','*','*','*',' ','*',' ','*','*','*',' ','*',' ',' ',' ',' ',' ',' ',' ','*'},
 {'*',' ',' ',' ','*','*','*',' ','*',' ',' ',' ',' ',' ',' ',' ','*',' ',' ',' ',' ',' ',' ','*',' ',' ',' ',' ',' ',' ',' ','*',' ','*','*','*',' ','*','*','*'},
 {'*',' ',' ',' ',' ',' ','*',' ','*','*','*','*','*','*','*',' ','*',' ','*','*','*','*',' ','*',' ','*','*','*','*','*','*','*',' ','*',' ',' ',' ',' ',' ','*'},
 {'*',' ',' ','*','*',' ','*',' ',' ',' ',' ',' ',' ','*',' ',' ','*',' ',' ','*','*',' ',' ','*',' ',' ','*',' ',' ',' ',' ',' ',' ','*',' ','*','*','*',' ','*'},
 {'*',' ',' ',' ','*',' ','*','*','*','*',' ','*',' ','*',' ','*','*','*',' ',' ',' ',' ','*','*','*',' ','*',' ','*',' ','*','*','*','*',' ','*',' ',' ',' ','*'},
 {'*',' ',' ',' ','*',' ',' ',' ',' ','*',' ','*',' ',' ',' ',' ',' ',' ',' ','*','*',' ',' ',' ',' ',' ',' ',' ','*',' ','*',' ',' ',' ',' ','*',' ','*',' ','*'},
 {'*',' ',' ',' ','*','*','*','*',' ','*',' ','*',' ','*','*','*','*',' ','*','*','*','*',' ','*','*','*','*',' ','*',' ','*',' ','*','*','*','*',' ','*',' ','*'},
 {'*',' ',' ',' ',' ',' ',' ','*',' ',' ',' ','*',' ',' ',' ','*',' ',' ',' ',' ',' ',' ',' ',' ','*',' ',' ',' ','*',' ',' ',' ','*',' ',' ',' ',' ','*',' ','*'},
 {'*',' ',' ','*','*','*',' ','*',' ','*',' ','*',' ','*',' ','*',' ','*','*',' ',' ','*','*',' ','*',' ','*',' ','*',' ','*',' ','*',' ','*','*','*','*',' ','*'},
 {'*',' ',' ',' ',' ',' ',' ',' ',' ','*',' ',' ',' ','*',' ',' ',' ','*',' ',' ',' ',' ','*',' ',' ',' ','*',' ',' ',' ','*',' ',' ',' ',' ',' ',' ',' ',' ','*'},
 {'*','*','*','*','*','*','*','*','*','*','*','*','*','*','*','*','*','*','*','*','*','*','*','*','*','*','*','*','*','*','*','*','*','*','*','*','*','*','*','*'}};
