{{'*','*','*','*','*','*','*','*','*','*','*','*','*','*','*','*','*','*','*','*','*','*','*','*','*','*','*','*','*','*','*','*','*','*','*','*','*','*','*','*'},
 {'*',' ',' ',' ',' ',' ',' ',' ',' ','*',' ',' ',' ','*',' ',' ',' ','*','V','*',' ',' ','*',' ',' ',' ','*',' ',' ',' ','*',' ',' ',' ',' ',' ',' ',' ',' ','*'},
 {'*',' ',' ','*','*','*','*','*','*','*','*','*','*','*','*','*','*','*',' ','*','*','*','*','*','*','*','*','*','*','*','*','*','*','*','*','*','*','*','*','*'},
 {'*',' ',' ',' ','*',' ','^',' ',' ',' ',' ',' ',' ',' ',' ',' ',' ',' ','O',' ',' ',' ',' ',' ',' ',' ',' ',' ',' ',' ',' ',' ',' ',' ',' ',' ',' ','<',' ','*'},
 {'*',' ',' ',' ','*','*','*','*','*','*','*','*','*','*','*','*','*','*',' ','*','*','*','*','*','*','*','*','*','*','*','*','*','*','*','*','*','*','*','*','*'},
 {'*',' ',' ',' ','*',' ',' ',' ',' ','*',' ','*',' ',' ',' ',' ',' ','*',' ','*','*',' ',' ',' ',' ',' ',' ',' ','*',' ','*',' ',' ',' ',' ','*',' ','*',' ','*'},
 {'*',' ',' ',' ','*',' ','*','*','*','*',' ','*',' ','*',' ','*','*','*',' ','*',' ',' ','*','*','*',' ','*',' ','*',' ','*','*','*','*',' ','*',' ',' ',' ','*'},
 {'*',' ',' ','*','*',' ','*',' ',' ',' ',' ',' ',' ','*',' ',' ','*','*',' ','*','*',' ',' ','*',' ',' ','*',' ',' ',' ',' ',' ',' ','*',' ','*','*','*',' ','*'},
 {'*',' ',' ',' ',' ',' ','*',' ','*','*','*','*','*','*','*',' ','*','*',' ','*','*','*',' ','*',' ','*','*','*','*','*','*','*',' ','*',' ',' ',' ',' ',' ','*'},
 {'*',' ',' ',' ','*','*','*',' ','*',' ',' ',' ',' ',' ',' ',' ','*','*',' ','*',' ',' ',' ','*',' ',' ',' ',' ',' ',' ',' ','*',' ','*','*','*',' ','*','*','*'},
 {'*',' ',' ',' ',' ',' ',' ',' ','*',' ','*','*','*',' ','*',' ','*','*',' ','*','*','*','*','*',' ','*',' ','*','*','*',' ','*',' ',' ',' ',' ',' ',' ',' ','*'},
 {'*',' ',' ','*','*','*','*',' ','*',' ','*',' ',' ',' ','*',' ',' ','*','^','*',' ',' ',' ',' ',' ','*',' ',' ',' ','*',' ','*',' ','*','*','*','*','*',' ','*'},
 {'*',' ',' ',' ',' ',' ',' ',' ','*',' ','*',' ','*',' ','*',' ','*','*','*','*','*',' ','*','*',' ','*',' ','*',' ','*',' ','*',' ',' ',' ',' ',' ',' ',' ','*'},
 {'*',' ',' ',' ','*',' ','*','*','*',' ',' ',' ',' ',' ',' ',' ','*',' ',' ',' ','*',' ',' ','*',' ',' ',' ',' ',' ',' ',' ','*','*','*',' ','*',' ','*','*','*'},
 {'*',' ',' ',' ','*',' ',' ',' ','*',' ','*','*','*',' ','*','*','*',' ','*','*','*',' ','*','*','*','*',' ','*','*','*',' ','*',' ',' ',' ','*',' ',' ',' ','*'},
 {'*',' ','*','*','*',' ','*',' ',' ',' ',' ',' ',' ',' ','*',' ',' ',' ',' ','*',' ',' ',' ',' ',' ','*',' ',' ',' ',' ',' ',' ',' ','*',' ','*','*',' ',' ','*'},
 {'*',' ',' ',' ','*',' ','*','*','*','*','*',' ','*','*','*',' ','*','*',' ','*','*','*','*','*',' ','*','*','*',' ','*','*','*','*','*',' ','*',' ',' ',' ','*'},
 {'*','*','*',' ',' ',' ','*',' ',' ',' ','*',' ','*',' ','*',' ','*',' ',' ',' ',' ',' ',' ','*',' ',' ',' ',' ',' ','*',' ',' ',' ','*',' ',' ',' ','*','*','*'},
 {'*',' ','*',' ','*',' ',' ',' ','*',' ','*',' ',' ',' ',' ',' ','*',' ','*',' ','*','*',' ',' ',' ','*',' ','*',' ','*',' ','*',' ',' ',' ','*',' ','*',' ','*'},
 {'*',' ',' ',' ','*','*',' ','*','*',' ','*',' ','*','*','*',' ','*',' ','*',' ','O','*',' ','*','*','*',' ','*',' ','*',' ','*','*',' ','*','*',' ',' ',' ','*'},
 {'*',' ',' ',' ','*','*',' ','*','*',' ','*',' ','*',' ','*','*','*',' ','*',' ',' ','*',' ','*',' ','*','*','*',' ','*',' ','*','*',' ','*','*',' ',' ',' ','*'},
 {'*',' ','*',' ','*',' ',' ',' ','*',' ','*',' ','*',' ','*',' ',' ',' ','*','*',' ','*',' ','*',' ',' ',' ',' ',' ','*',' ','*',' ',' ',' ','*',' ','*',' ','*'},
 {'*','*','*',' ',' ',' ','*',' ',' ',' ','*',' ',' ',' ',' ',' ','*',' ',' ',' ',' ',' ',' ','*',' ','*',' ','*',' ','*',' ',' ',' ','*',' ',' ',' ','*','*','*'},
 {'*',' ',' ',' ','*',' ','*','*','*','*','*',' ','*','*','*',' ','*','*','*','*','*',' ','*','*',' ','*','*','*',' ','*','*','*','*','*',' ','*',' ',' ',' ','*'},
 {'*',' ','*','*','*',' ','*',' ',' ',' ',' ',' ',' ',' ','*',' ',' ',' ',' ',' ','*',' ',' ',' ',' ','*',' ',' ',' ',' ',' ',' ',' ','*',' ','*','*',' ',' ','*'},
 {'*',' ',' ',' ','*',' ',' ',' ','*',' ','*','*','*',' ','*','*','*','*',' ','*','*','*',' ','*','*','*',' ','*','*','*',' ','*',' ',' ',' ','*',' ',' ',' ','*'},
 {'*',' ',' ',' ',' ',' ','*',' ','*','*','*','*','*','*','*',' ','*',' ','*','*','*','*',' ','*',' ','*','*','*','*','*','*','*',' ','*',' ',' ',' ',' ',' ','*'},
 {'*',' ',' ','*','*',' ','*',' ',' ',' ',' ',' ',' ','*',' ',' ','*',' ',' ','*','*',' ',' ','*',' ',' ','*',' ',' ',' ',' ',' ',' ','*',' ','*','*',' ',' ','*'},
 {'*',' ',' ',' ','*',' ','*','*','*',' ',' ',' ',' ',' ',' ',' ','*',' ',' ','*',' ',' ',' ','*',' ',' ',' ',' ',' ',' ',' ','*','*','*',' ','*',' ','*','*','*'},
 {'*',' ',' ',' ','*',' ',' ',' ','*',' ','*','*','*',' ','*',' ','*','*','*',' ',' ',' ',' ','*','*','*',' ','*',' ','*',' ','*','*','*','*',' ','*',' ',' ','*'},
 {'*',' ','*',' ','*',' ',' ',' ','*',' ','*',' ','*',' ','*',' ',' ',' ','*','*',' ','*',' ','*',' ',' ',' ',' ',' ','*',' ','*',' ',' ',' ','*',' ','*',' ','*'},
 {'*','*','*',' ',' ',' ','*',' ',' ',' ','*',' ',' ',' ',' ',' ','*',' ',' ',' ',' ',' ',' ','*',' ','*',' ','*',' ','*',' ',' ',' ','*',' ',' ',' ','*','*','*'},
 {'*',' ',' ',' ','*',' ','*','*','*','*','*',' ','*','*','*',' ','*','*','*','*','*',' ','*','*',' ','*','*','*',' ','*','*','*','*','*',' ','*',' ',' ',' ','*'},
 {'*',' ','*','*','*',' ','*',' ',' ',' ',' ',' ',' ',' ','*',' ',' ',' ',' ',' ','*',' ',' ',' ',' ',' ','*',' ',' ',' ','*',' ','*',' ','*','*','*','*','*','*'},
 {'*',' ',' ',' ','*',' ',' ',' ','*',' ','*','*','*',' ','*','*','*',' ','*','*','*',' ','*','*','*','*',' ','*','*','*',' ','*',' ',' ',' ','*',' ',' ',' ','*'},
 {'*',' ',' ',' ',' ',' ','*',' ','*','*','*','*','*','*','*',' ','*',' ','*','*','*','*',' ','*',' ','*','*','*','*','*','*','*',' ','*',' ',' ',' ',' ','*','*'},
 {'*',' ',' ','*','*',' ','*',' ',' ',' ',' ',' ',' ','*',' ',' ','*',' ',' ','*','*',' ',' ','*',' ',' ','*',' ',' ',' ',' ',' ',' ',' ','*',' ','*','*',' ','*'},
 {'*',' ',' ',' ','*',' ','*','*','*','*',' ','*',' ','*',' ','*','*','*',' ',' ',' ',' ','*','*','*',' ','*',' ','*',' ','*','*','*','*',' ','*',' ',' ',' ','*'},
 {'*',' ',' ',' ','*',' ',' ',' ',' ','*',' ','*',' ',' ',' ',' ',' ',' ','*','*',' ',' ',' ',' ',' ',' ',' ','*',' ','*',' ',' ',' ',' ','*',' ','*','*','*','*'},
 {'*',' ',' ',' ','*','*','*','*',' ','*',' ','*',' ','*','*','*','*',' ','*','*','*','*',' ','*','*','*','*',' ','*',' ','*',' ','*','*','*',' ','*',' ','*','*'},
 {'*',' ',' ',' ',' ',' ',' ','*',' ',' ',' ','*',' ',' ',' ','*',' ',' ',' ',' ',' ',' ',' ',' ','*',' ',' ',' ','*',' ',' ',' ','*',' ',' ',' ',' ','*',' ','*'},
 {'*',' ',' ','*','*','*',' ','*',' ','*',' ','*',' ','*',' ','*',' ','*','*',' ',' ','*','*',' ','*',' ','*',' ','*',' ','*',' ','*',' ','*','*','*','*','*','*'},
 {'*',' ',' ',' ',' ',' ',' ',' ',' ','*',' ',' ',' ','*',' ',' ',' ','*',' ',' ',' ',' ','*',' ',' ',' ','*',' ',' ',' ','*',' ',' ',' ',' ',' ',' ',' ',' ','*'},
 {'*','*','*','*','*','*','*','*','*','*','*','*','*','*','*','*','*','*','*','*','*','*','*','*','*','*','*','*','*','*','*','*','*','*','*','*','*','*','*','*'}};
