{{'*','*','*','*','*','*','*','*','*','*','*','*','*','*','*','*','*','*','*','*','*','*','*','*','*','*','*','*','*','*','*','*','*','*','*','*','*','*','*','*'},
    {'*','V',' ',' ',' ',' ',' ',' ',' ',' ',' ',' ',' ',' ',' ',' ',' ',' ',' ',' ',' ',' ',' ',' ',' ',' ',' ',' ',' ',' ',' ',' ',' ',' ',' ',' ',' ',' ','V','*'},
     {'*',' ','*','*',' ',' ','*','*',' ',' ','*','*',' ',' ','*','*',' ',' ','*','*',' ',' ','*','*',' ',' ','*','*',' ',' ','*','*',' ',' ','*','*',' ',' ',' ','*'},
     {'*',' ',' ',' ',' ',' ',' ',' ',' ',' ',' ',' ',' ',' ',' ',' ',' ',' ','*',' ',' ',' ',' ',' ',' ',' ',' ',' ',' ',' ',' ',' ',' ',' ',' ','*',' ',' ',' ','*'},
     {'*',' ','*',' ',' ',' ',' ',' ',' ',' ',' ',' ',' ',' ',' ',' ',' ',' ','*',' ',' ',' ',' ',' ',' ',' ',' ',' ',' ',' ',' ',' ',' ',' ','*',' ',' ',' ',' ','*'},
     {'*',' ',' ','*',' ',' ',' ',' ',' ',' ',' ',' ',' ',' ',' ',' ',' ',' ','*',' ',' ',' ',' ',' ',' ',' ',' ',' ',' ',' ',' ',' ',' ','*',' ',' ',' ',' ',' ','*'},
     {'*',' ',' ',' ','*',' ',' ',' ',' ',' ',' ',' ',' ',' ',' ',' ',' ',' ','*',' ',' ',' ',' ',' ',' ',' ',' ',' ',' ',' ',' ',' ','*',' ',' ',' ',' ',' ',' ','*'},
     {'*',' ',' ',' ',' ','*',' ',' ',' ',' ',' ',' ',' ',' ',' ',' ',' ',' ','*',' ',' ',' ',' ',' ',' ',' ',' ',' ',' ',' ',' ','*',' ',' ',' ',' ',' ',' ',' ','*'},
     {'*',' ',' ',' ',' ',' ','*',' ',' ',' ',' ',' ',' ',' ',' ',' ',' ',' ','*',' ',' ',' ',' ',' ',' ',' ',' ',' ',' ',' ','*',' ',' ',' ',' ',' ',' ',' ',' ','*'},
     {'*',' ',' ',' ',' ',' ',' ','*',' ',' ',' ',' ',' ',' ',' ',' ',' ',' ','*',' ',' ',' ',' ',' ',' ',' ',' ',' ',' ','*',' ',' ',' ',' ',' ',' ',' ',' ',' ','*'},
     {'*',' ',' ',' ',' ',' ',' ',' ','*',' ',' ',' ',' ',' ',' ',' ',' ',' ','*',' ',' ',' ',' ',' ',' ',' ',' ',' ','*',' ',' ',' ',' ',' ',' ',' ',' ',' ',' ','*'},
     {'*',' ',' ',' ',' ',' ',' ',' ',' ','*',' ',' ',' ',' ',' ',' ',' ',' ','*',' ',' ',' ',' ',' ',' ',' ',' ','*',' ',' ',' ',' ',' ',' ',' ',' ',' ',' ',' ','*'},
     {'*',' ',' ',' ',' ',' ',' ',' ',' ',' ','*',' ',' ',' ',' ',' ',' ',' ','*',' ',' ',' ',' ',' ',' ',' ','*',' ',' ',' ',' ',' ',' ',' ',' ',' ',' ',' ',' ','*'},
     {'*',' ',' ',' ',' ',' ',' ',' ',' ',' ',' ','*',' ',' ',' ',' ',' ',' ','*',' ',' ',' ',' ',' ',' ','*',' ',' ',' ',' ',' ',' ',' ',' ',' ',' ',' ',' ',' ','*'},
     {'*',' ',' ',' ',' ',' ',' ',' ',' ',' ',' ',' ','*',' ',' ',' ',' ',' ','*',' ',' ',' ',' ',' ','*',' ',' ',' ',' ',' ',' ',' ',' ',' ',' ',' ',' ',' ',' ','*'},
     {'*',' ',' ',' ',' ',' ',' ',' ',' ',' ',' ',' ',' ','*',' ',' ',' ',' ','*',' ',' ',' ',' ','*',' ',' ',' ',' ',' ',' ',' ',' ',' ',' ',' ',' ',' ',' ',' ','*'},
     {'*',' ',' ',' ',' ',' ',' ',' ',' ',' ',' ',' ',' ',' ','*',' ',' ',' ','*',' ',' ',' ','*',' ',' ',' ',' ',' ',' ',' ',' ',' ',' ',' ',' ',' ',' ',' ',' ','*'},
     {'*',' ',' ',' ',' ',' ',' ',' ',' ',' ',' ',' ',' ',' ',' ','*',' ',' ','*',' ',' ','*',' ',' ',' ',' ',' ',' ',' ',' ',' ',' ',' ',' ',' ',' ',' ',' ',' ','*'},
     {'*',' ',' ',' ',' ',' ',' ',' ',' ',' ',' ',' ',' ',' ',' ',' ',' ',' ',' ',' ',' ',' ',' ',' ',' ',' ',' ',' ',' ',' ',' ',' ',' ',' ',' ',' ',' ',' ',' ','*'},
     {'*',' ',' ',' ',' ',' ',' ',' ',' ',' ',' ',' ',' ',' ',' ',' ',' ','*','O','*',' ',' ',' ',' ',' ',' ',' ',' ',' ',' ',' ',' ',' ',' ',' ',' ',' ',' ',' ','*'},
     {'*',' ',' ',' ',' ',' ',' ',' ',' ',' ',' ',' ',' ',' ',' ',' ',' ',' ',' ',' ',' ',' ',' ',' ',' ',' ',' ',' ',' ',' ',' ',' ',' ',' ',' ',' ',' ',' ',' ','*'},
     {'*',' ',' ','*',' ',' ','*',' ',' ','*',' ',' ',' ','*',' ',' ',' ',' ',' ','*',' ',' ',' ',' ','*',' ',' ',' ','*',' ',' ','*',' ',' ','*',' ','*',' ',' ','*'},
     {'*',' ',' ','*',' ',' ','*',' ',' ','*',' ',' ',' ','*',' ',' ',' ',' ',' ','*',' ',' ',' ',' ','*',' ',' ',' ','*',' ',' ','*',' ',' ','*',' ','*',' ',' ','*'},
     {'*',' ',' ','*',' ',' ','*',' ',' ','*',' ',' ',' ','*',' ',' ',' ',' ',' ','*',' ',' ',' ',' ','*',' ',' ',' ','*',' ',' ','*',' ',' ','*',' ','*',' ',' ','*'},
     {'*',' ',' ','*',' ',' ','*',' ',' ','*',' ',' ',' ','*',' ',' ',' ',' ',' ','*',' ',' ',' ',' ','*',' ',' ',' ','*',' ',' ','*',' ',' ','*',' ','*',' ',' ','*'},
     {'*',' ',' ','*',' ',' ','*',' ',' ','*',' ',' ',' ','*',' ',' ',' ',' ',' ','*',' ',' ',' ',' ','*',' ',' ',' ','*',' ',' ','*',' ',' ','*',' ','*',' ',' ','*'},
     {'*',' ',' ','*',' ',' ','*',' ',' ','*',' ',' ',' ','*',' ',' ',' ',' ',' ','*',' ',' ',' ',' ','*',' ',' ',' ','*',' ',' ','*',' ',' ','*',' ','*',' ',' ','*'},
     {'*',' ',' ','*',' ',' ','*',' ',' ','*',' ',' ',' ','*',' ',' ',' ',' ',' ','*',' ',' ',' ',' ','*',' ',' ',' ','*',' ',' ','*',' ',' ','*',' ','*',' ',' ','*'},
     {'*',' ',' ','*',' ',' ','*',' ',' ','*',' ',' ',' ','*',' ',' ',' ',' ',' ','*',' ',' ',' ',' ','*',' ',' ',' ','*',' ',' ','*',' ',' ','*',' ','*',' ',' ','*'},
     {'*',' ',' ','*',' ',' ','*',' ',' ','*',' ',' ',' ','*',' ',' ',' ',' ',' ','*',' ',' ',' ',' ','*',' ',' ',' ','*',' ',' ','*',' ',' ','*',' ','*',' ',' ','*'},
     {'*',' ',' ','*',' ',' ','*',' ',' ','*',' ',' ',' ','*',' ',' ',' ',' ',' ','*',' ',' ',' ',' ','*',' ',' ',' ','*',' ',' ','*',' ',' ','*',' ','*',' ',' ','*'},
     {'*',' ',' ','*',' ',' ','*',' ',' ','*',' ',' ',' ','*',' ',' ',' ',' ',' ','*',' ',' ',' ',' ','*',' ',' ',' ','*',' ',' ','*',' ',' ','*',' ','*',' ',' ','*'},
     {'*',' ',' ','*',' ',' ','*',' ',' ','*',' ',' ',' ','*',' ',' ',' ',' ',' ','*',' ',' ',' ',' ','*',' ',' ',' ','*',' ',' ','*',' ',' ','*',' ','*',' ',' ','*'},
     {'*',' ',' ','*',' ',' ','*',' ',' ','*',' ',' ',' ','*',' ',' ',' ',' ',' ','*',' ',' ',' ',' ','*',' ',' ',' ','*',' ',' ','*',' ',' ','*',' ','*',' ',' ','*'},
     {'*',' ',' ','*',' ',' ','*',' ',' ','*',' ',' ',' ','*',' ',' ',' ',' ',' ','*',' ',' ',' ',' ','*',' ',' ',' ','*',' ',' ','*',' ',' ','*',' ','*',' ',' ','*'},
     {'*',' ',' ','*',' ',' ','*',' ',' ','*',' ',' ',' ','*',' ',' ',' ',' ',' ','*',' ',' ',' ',' ','*',' ',' ',' ','*',' ',' ','*',' ',' ','*',' ','*',' ',' ','*'},
     {'*',' ',' ','*',' ',' ','*',' ',' ','*',' ',' ',' ','*',' ',' ',' ',' ',' ','*',' ',' ',' ',' ','*',' ',' ',' ','*',' ',' ','*',' ',' ','*',' ','*',' ',' ','*'},
     {'*',' ',' ','*',' ',' ','*',' ',' ','*',' ',' ',' ','*',' ',' ',' ',' ',' ','*',' ',' ',' ',' ','*',' ',' ',' ','*',' ',' ','*',' ',' ','*',' ','*',' ',' ','*'},
     {'*','^',' ',' ',' ',' ',' ',' ',' ',' ',' ',' ',' ',' ',' ',' ',' ',' ',' ','*',' ',' ',' ',' ',' ',' ',' ',' ',' ',' ',' ',' ',' ',' ',' ',' ',' ',' ','^','*'},
    {'*','*','*','*','*','*','*','*','*','*','*','*','*','*','*','*','*','*','*','*','*','*','*','*','*','*','*','*','*','*','*','*','*','*','*','*','*','*','*','*'}};
