{{'*','*','*','*','*','*','*','*','*','*','*','*','*','*','*','*','*','*','*','*','*','*','*','*','*','*','*','*','*','*','*','*','*','*','*','*','*','*','*','*'},
 {'*',' ',' ',' ',' ',' ',' ',' ',' ',' ',' ',' ',' ',' ',' ',' ',' ',' ',' ',' ',' ',' ',' ',' ',' ',' ',' ',' ',' ',' ',' ',' ',' ',' ',' ',' ',' ',' ','<','*'},
 {'*',' ',' ',' ',' ',' ',' ',' ',' ',' ',' ',' ',' ',' ',' ',' ',' ',' ',' ',' ',' ',' ',' ',' ',' ',' ',' ',' ',' ',' ',' ',' ',' ',' ',' ','*',' ',' ',' ','*'},
 {'*',' ',' ','*',' ',' ','*',' ',' ','*',' ',' ',' ',' ','*',' ',' ',' ',' ',' ',' ',' ',' ',' ',' ',' ',' ',' ',' ','*',' ',' ',' ',' ',' ',' ',' ',' ',' ','*'},
 {'*',' ',' ',' ','*',' ','*',' ','*',' ',' ',' ',' ',' ',' ',' ',' ',' ','*',' ',' ',' ',' ',' ',' ',' ',' ',' ',' ',' ',' ',' ',' ',' ',' ',' ',' ',' ',' ','*'},
 {'*',' ',' ',' ',' ','*','*','*',' ',' ',' ',' ',' ',' ',' ',' ',' ',' ',' ',' ',' ',' ',' ',' ',' ',' ',' ',' ',' ',' ',' ',' ',' ',' ',' ',' ',' ',' ','*','*'},
 {'*',' ',' ','*','*','*','*','*','*','*',' ',' ',' ',' ',' ',' ',' ',' ',' ',' ',' ','*',' ',' ','*',' ',' ','*',' ',' ','*',' ',' ',' ',' ',' ',' ',' ',' ','*'},
 {'*',' ',' ',' ',' ','*','*','*',' ',' ',' ',' ','*',' ',' ',' ',' ',' ',' ',' ',' ',' ',' ',' ',' ','*',' ','*',' ','*',' ',' ',' ',' ',' ',' ',' ',' ',' ','*'},
 {'*',' ',' ',' ','*',' ','*',' ','*',' ',' ',' ',' ',' ',' ',' ',' ',' ',' ',' ',' ',' ',' ',' ',' ',' ','*','*','*',' ',' ',' ',' ',' ','*',' ',' ',' ',' ','*'},
 {'*',' ',' ','*',' ',' ','*',' ',' ','*',' ',' ',' ',' ',' ',' ',' ',' ',' ',' ',' ',' ',' ',' ','*','*','*','*','*','*','*',' ',' ',' ',' ',' ',' ',' ',' ','*'},
 {'*',' ',' ',' ',' ',' ',' ',' ',' ',' ',' ',' ',' ',' ',' ',' ',' ','*',' ',' ',' ',' ',' ',' ',' ',' ','*','*','*',' ',' ',' ',' ',' ',' ',' ',' ',' ',' ','*'},
 {'*',' ',' ',' ',' ','*',' ',' ',' ',' ',' ',' ',' ',' ',' ',' ',' ',' ',' ',' ',' ',' ',' ',' ',' ','*',' ','*',' ','*',' ',' ',' ',' ',' ',' ',' ','*',' ','*'},
 {'*',' ',' ',' ',' ',' ',' ',' ',' ',' ',' ',' ',' ',' ',' ',' ',' ',' ',' ',' ',' ',' ',' ',' ','*',' ',' ','*',' ',' ','*',' ',' ',' ',' ',' ',' ',' ',' ','*'},
 {'*',' ',' ','*',' ',' ',' ',' ',' ','*',' ',' ',' ',' ',' ',' ',' ',' ',' ',' ',' ',' ',' ',' ',' ',' ',' ',' ',' ',' ',' ',' ',' ',' ','*',' ',' ',' ',' ','*'},
 {'*',' ',' ',' ',' ',' ',' ',' ',' ',' ',' ',' ',' ',' ','*',' ',' ','*',' ',' ','*',' ',' ',' ',' ',' ',' ',' ',' ',' ',' ',' ',' ',' ',' ',' ',' ',' ',' ','*'},
 {'*',' ',' ',' ',' ',' ',' ',' ',' ',' ',' ',' ',' ',' ',' ','*',' ','*',' ','*',' ',' ',' ',' ',' ',' ',' ',' ',' ',' ',' ',' ',' ',' ',' ',' ',' ',' ',' ','*'},
 {'*',' ',' ',' ',' ','*',' ',' ',' ',' ',' ',' ',' ',' ',' ',' ','*','*','*',' ',' ',' ',' ',' ',' ',' ',' ',' ',' ',' ',' ',' ',' ',' ',' ',' ',' ',' ',' ','*'},
 {'*',' ',' ',' ',' ',' ',' ',' ',' ',' ',' ','*',' ',' ','*','*','*','*','*','*','*','^',' ',' ',' ',' ',' ',' ',' ',' ',' ',' ',' ',' ',' ',' ',' ','*',' ','*'},
 {'*',' ','*',' ',' ','*',' ',' ','*',' ',' ',' ',' ',' ',' ',' ','*','*','*',' ',' ',' ',' ',' ',' ',' ',' ',' ',' ',' ',' ',' ',' ',' ',' ',' ',' ',' ',' ','*'},
 {'*',' ',' ','*',' ','*',' ','*',' ',' ',' ',' ',' ',' ',' ','*',' ','*',' ','*',' ',' ',' ',' ',' ',' ',' ','*',' ',' ','*',' ',' ','*',' ',' ',' ',' ',' ','*'},
 {'*',' ',' ',' ','*','*','*',' ',' ',' ',' ',' ',' ',' ','*',' ',' ','*',' ',' ','*',' ',' ',' ',' ',' ',' ',' ','*',' ','*',' ','*',' ',' ',' ',' ',' ',' ','*'},
 {'*',' ','*','*','*','*','*','*','*',' ','*',' ',' ',' ',' ',' ',' ',' ',' ',' ',' ',' ',' ',' ',' ',' ',' ',' ',' ','*','*','*',' ',' ',' ',' ',' ',' ',' ','*'},
 {'*',' ',' ',' ','*','*','*',' ',' ',' ',' ',' ',' ',' ',' ',' ',' ',' ',' ',' ',' ',' ',' ',' ',' ',' ',' ','*','*','*','*','*','*','*',' ',' ',' ',' ',' ','*'},
 {'*',' ',' ','*',' ','*',' ','*',' ',' ',' ',' ',' ',' ',' ',' ',' ',' ',' ',' ',' ',' ',' ',' ',' ',' ',' ',' ',' ','*','*','*',' ',' ',' ',' ','*',' ',' ','*'},
 {'*',' ','*',' ',' ','*',' ',' ','*',' ',' ',' ',' ',' ','*',' ',' ',' ',' ',' ','*',' ',' ',' ',' ',' ',' ',' ','*',' ','*',' ','*',' ',' ',' ',' ',' ',' ','*'},
 {'*',' ',' ',' ',' ',' ',' ',' ',' ',' ',' ',' ',' ',' ',' ',' ',' ',' ',' ',' ',' ',' ',' ',' ',' ',' ',' ','*',' ',' ','*',' ',' ','*',' ',' ',' ',' ',' ','*'},
 {'*',' ',' ',' ',' ',' ',' ',' ',' ',' ',' ',' ',' ',' ',' ',' ',' ',' ',' ',' ',' ',' ',' ',' ',' ',' ',' ',' ',' ',' ',' ',' ',' ',' ',' ',' ',' ',' ',' ','*'},
 {'*',' ',' ',' ',' ',' ',' ',' ',' ',' ',' ',' ',' ',' ',' ',' ',' ','*',' ',' ',' ',' ',' ',' ',' ',' ',' ',' ',' ',' ',' ',' ',' ',' ',' ',' ',' ',' ',' ','*'},
 {'*',' ',' ',' ',' ','*',' ',' ','*',' ',' ','*',' ',' ',' ',' ',' ',' ',' ',' ',' ',' ',' ',' ',' ',' ',' ',' ',' ',' ',' ',' ',' ',' ',' ',' ',' ',' ',' ','*'},
 {'*',' ',' ',' ',' ',' ','*',' ','*',' ','*',' ',' ',' ',' ',' ',' ',' ',' ',' ',' ','*',' ',' ','*',' ',' ','*',' ',' ',' ',' ',' ',' ',' ','*',' ',' ',' ','*'},
 {'*',' ',' ',' ',' ',' ',' ','*','*','*',' ',' ',' ',' ',' ',' ',' ',' ',' ',' ',' ',' ','*',' ','*',' ','*',' ',' ',' ',' ',' ',' ',' ',' ',' ',' ',' ',' ','*'},
 {'*',' ',' ',' ',' ','*','*','*','*','*','*','*',' ',' ',' ',' ',' ',' ',' ',' ',' ',' ',' ','*','*','*',' ',' ',' ',' ',' ',' ','*',' ',' ',' ',' ',' ',' ','*'},
 {'*',' ',' ',' ',' ',' ',' ','*','*','*',' ',' ',' ',' ',' ','*',' ',' ',' ',' ',' ','*','*','*','*','*','*','*',' ',' ',' ',' ',' ',' ',' ',' ',' ',' ',' ','*'},
 {'*',' ',' ',' ',' ',' ','*',' ','*',' ','*',' ',' ',' ',' ',' ',' ',' ',' ',' ',' ',' ',' ','*','*','*',' ',' ',' ',' ',' ',' ',' ',' ',' ',' ',' ',' ',' ','*'},
 {'*',' ',' ',' ',' ','*',' ','<','*',' ',' ','*',' ',' ',' ',' ',' ',' ',' ',' ',' ',' ','*',' ','*',' ','*',' ',' ',' ',' ',' ',' ',' ',' ','*',' ',' ',' ','*'},
 {'*',' ',' ',' ',' ',' ',' ',' ',' ',' ',' ',' ',' ',' ',' ',' ',' ',' ',' ',' ',' ','*',' ',' ','*',' ',' ','*',' ',' ','*',' ',' ',' ',' ',' ',' ',' ',' ','*'},
 {'*',' ',' ','O',' ',' ',' ',' ',' ',' ',' ',' ',' ','*',' ',' ',' ','*',' ',' ',' ',' ',' ',' ',' ',' ',' ',' ',' ',' ',' ',' ',' ',' ',' ',' ',' ',' ',' ','*'},
 {'*',' ',' ',' ',' ',' ',' ',' ',' ',' ',' ',' ',' ',' ',' ',' ',' ',' ',' ',' ',' ',' ',' ',' ',' ',' ',' ',' ',' ',' ',' ',' ',' ',' ',' ',' ',' ',' ',' ','*'},
 {'*',' ',' ',' ',' ',' ',' ',' ',' ',' ',' ',' ',' ',' ',' ',' ',' ',' ',' ',' ',' ',' ',' ',' ',' ',' ',' ',' ',' ',' ',' ',' ',' ',' ',' ',' ',' ',' ','V','*'},
 {'*','*','*','*','*','*','*','*','*','*','*','*','*','*','*','*','*','*','*','*','*','*','*','*','*','*','*','*','*','*','*','*','*','*','*','*','*','*','*','*'}};