{{'*','*','*','*','*','*','*','*','*','*','*','*','*','*','*','*','*','*','*','*','*','*','*','*','*','*','*','*','*','*','*','*','*','*','*','*','*','*','*','*'},
 {'*','>',' ',' ',' ',' ',' ',' ',' ','*',' ',' ',' ','*',' ',' ',' ',' ','*',' ',' ',' ','*',' ',' ',' ','*',' ',' ',' ','*',' ',' ',' ',' ',' ',' ',' ','<','*'},
 {'*',' ','*','*','*','*',' ','*',' ','*',' ','*',' ','*',' ','*',' ',' ','*','*',' ','*','*',' ','*',' ','*',' ','*',' ','*',' ','*',' ','*','*','*','*',' ','*'},
 {'*',' ','*',' ',' ',' ',' ','*',' ',' ',' ','*',' ',' ',' ','*',' ',' ',' ',' ',' ',' ',' ',' ','*',' ',' ',' ','*',' ',' ',' ','*',' ',' ',' ',' ','*',' ','*'},
 {'*',' ','*',' ','*','*','*','*',' ','*',' ','*',' ','*','*','*','*',' ','*','*','*','*',' ','*','*','*','*',' ','*',' ','*',' ','*','*','*','*',' ','*',' ','*'},
 {'*',' ','*',' ','*',' ',' ',' ',' ','*',' ','*',' ',' ',' ',' ',' ',' ',' ','*','*',' ',' ',' ',' ',' ',' ',' ','*',' ','*',' ',' ',' ',' ','*',' ','*',' ','*'},
 {'*',' ',' ',' ','*',' ','*','*','*','*',' ','*',' ','*',' ','*','*','*',' ',' ',' ',' ','*','*','*',' ','*',' ','*',' ','*','*','*','*',' ','*',' ',' ',' ','*'},
 {'*',' ','*','*','*',' ','*',' ',' ',' ',' ',' ',' ','*',' ',' ','*',' ',' ','*','*',' ',' ','*',' ',' ','*',' ',' ',' ',' ',' ',' ','*',' ','*','*','*',' ','*'},
 {'*',' ',' ',' ',' ',' ','*',' ','*','*','*','*','*','*','*',' ','*',' ','*','*','*','*',' ','*',' ','*','*','*','*','*','*','*',' ','*',' ',' ',' ',' ',' ','*'},
 {'*','*','*',' ','*','*','*',' ','*',' ',' ',' ',' ',' ',' ',' ','*',' ',' ',' ',' ',' ',' ','*',' ',' ',' ',' ',' ',' ',' ','*',' ','*','*','*',' ','*','*','*'},
 {'*',' ',' ',' ',' ',' ',' ',' ','*',' ','*','*','*',' ','*',' ','*','*','*','*','*','*','*','*',' ','*',' ','*','*','*',' ','*',' ',' ',' ',' ',' ',' ',' ','*'},
 {'*',' ','*','*','*','*','*',' ','*',' ','*',' ',' ',' ','*',' ',' ',' ',' ',' ',' ',' ',' ',' ',' ','*',' ',' ',' ','*',' ','*',' ','*','*','*','*','*',' ','*'},
 {'*',' ',' ',' ',' ',' ',' ',' ','*',' ','*',' ','*',' ','*',' ','*',' ','*','*','*',' ','*','*',' ','*',' ','*',' ','*',' ','*',' ',' ',' ',' ',' ',' ',' ','*'},
 {'*','*','*',' ','*',' ','*','*','*',' ',' ',' ',' ',' ',' ',' ','*',' ',' ',' ','*',' ',' ','*',' ',' ',' ',' ',' ',' ',' ','*','*','*',' ','*',' ','*','*','*'},
 {'*',' ',' ',' ','*',' ',' ',' ','*',' ','*','*','*',' ','*','*','*',' ','*','*','*',' ','*','*','*','*',' ','*','*','*',' ','*',' ',' ',' ','*',' ',' ',' ','*'},
 {'*',' ','*','*','*',' ','*',' ',' ',' ',' ',' ',' ',' ','*',' ',' ',' ',' ','*',' ',' ',' ',' ',' ','*',' ',' ',' ',' ',' ',' ',' ','*',' ','*','*','*',' ','*'},
 {'*',' ',' ',' ','*',' ','*','*','*','*','*',' ','*','*','*',' ','*','*',' ','*','*','*','*','*',' ','*','*','*',' ','*','*','*','*','*',' ','*',' ',' ',' ','*'},
 {'*','*','*',' ',' ',' ','*',' ',' ',' ','*',' ','*',' ','*',' ','*',' ',' ',' ',' ',' ',' ','*',' ',' ',' ',' ',' ','*',' ',' ',' ','*',' ',' ',' ','*','*','*'},
 {'*',' ','*',' ','*',' ',' ',' ','*',' ','*',' ',' ',' ',' ',' ','*',' ','*',' ','*','*',' ',' ',' ','*',' ','*',' ','*',' ','*',' ',' ',' ','*',' ','*',' ','*'},
 {'*',' ',' ',' ','*','*',' ','*','*',' ','*',' ','*','*','*',' ','*',' ','*',' ','O','*',' ','*','*','*',' ','*',' ','*',' ','*','*',' ','*','*',' ',' ',' ','*'},
 {'*',' ',' ',' ','*','*',' ','*','*',' ','*',' ','*',' ','*','*','*',' ','*',' ',' ','*',' ','*',' ','*','*','*',' ','*',' ','*','*',' ','*','*',' ',' ',' ','*'},
 {'*',' ','*',' ','*',' ',' ',' ','*',' ','*',' ','*',' ','*',' ',' ',' ','*','*',' ','*',' ','*',' ',' ',' ',' ',' ','*',' ','*',' ',' ',' ','*',' ','*',' ','*'},
 {'*','*','*',' ',' ',' ','*',' ',' ',' ','*',' ',' ',' ',' ',' ','*',' ',' ',' ',' ',' ',' ','*',' ','*',' ','*',' ','*',' ',' ',' ','*',' ',' ',' ','*','*','*'},
 {'*',' ',' ',' ','*',' ','*','*','*','*','*',' ','*','*','*',' ','*','*','*','*','*',' ','*','*',' ','*','*','*',' ','*','*','*','*','*',' ','*',' ',' ',' ','*'},
 {'*',' ','*','*','*',' ','*',' ',' ',' ',' ',' ',' ',' ','*',' ',' ',' ',' ',' ','*',' ',' ',' ',' ','*',' ',' ',' ',' ',' ',' ',' ','*',' ','*','*',' ',' ','*'},
 {'*',' ',' ',' ','*',' ',' ',' ','*',' ','*','*','*',' ','*','*','*','*',' ','*','*','*',' ','*','*','*',' ','*','*','*',' ','*',' ',' ',' ','*',' ',' ',' ','*'},
 {'*','*','*',' ','*',' ','*','*','*',' ',' ',' ',' ',' ',' ',' ','*',' ',' ','*',' ',' ',' ','*',' ',' ',' ',' ',' ',' ',' ','*','*','*',' ','*',' ','*','*','*'},
 {'*',' ',' ',' ',' ',' ',' ',' ','*',' ','*',' ','*',' ','*',' ','*','*',' ','*','*','*',' ','*',' ','*',' ','*',' ','*',' ','*',' ',' ',' ',' ',' ',' ',' ','*'},
 {'*',' ','*','*','*','*','*',' ','*',' ','*',' ',' ',' ','*',' ',' ',' ',' ',' ',' ',' ',' ',' ',' ','*',' ',' ',' ','*',' ','*',' ','*','*','*','*','*',' ','*'},
 {'*',' ',' ',' ',' ',' ',' ',' ','*',' ','*','*','*',' ','*',' ','*','*','*','*','*','*','*','*',' ','*',' ','*','*','*',' ','*',' ',' ',' ',' ',' ',' ',' ','*'},
 {'*','*','*',' ','*','*','*',' ','*',' ',' ',' ',' ',' ',' ',' ','*',' ',' ',' ',' ',' ',' ','*',' ',' ',' ',' ',' ',' ',' ','*',' ','*','*','*',' ','*','*','*'},
 {'*',' ',' ',' ',' ',' ','*',' ','*','*','*','*','*','*','*',' ','*',' ','*','*','*','*',' ','*',' ','*','*','*','*','*','*','*',' ','*',' ',' ',' ',' ',' ','*'},
 {'*',' ','*','*','*',' ','*',' ',' ',' ',' ',' ',' ','*',' ',' ','*',' ',' ','*','*',' ',' ','*',' ',' ','*',' ',' ',' ',' ',' ',' ','*',' ','*','*','*',' ','*'},
 {'*',' ',' ',' ','*',' ','*','*','*','*',' ','*',' ','*',' ','*','*','*',' ',' ',' ',' ','*','*','*',' ','*',' ','*',' ','*','*','*','*',' ','*',' ',' ',' ','*'},
 {'*',' ','*',' ','*',' ',' ',' ',' ','*',' ','*',' ',' ',' ',' ',' ',' ',' ','*','*',' ',' ',' ',' ',' ',' ',' ','*',' ','*',' ',' ',' ',' ','*',' ','*',' ','*'},
 {'*',' ','*',' ','*','*','*','*',' ','*',' ','*',' ','*','*','*','*',' ','*','*','*','*',' ','*','*','*','*',' ','*',' ','*',' ','*','*','*','*',' ','*',' ','*'},
 {'*',' ','*',' ',' ',' ',' ','*',' ',' ',' ','*',' ',' ',' ','*',' ',' ',' ',' ',' ',' ',' ',' ','*',' ',' ',' ','*',' ',' ',' ','*',' ',' ',' ',' ','*',' ','*'},
 {'*',' ','*','*','*','*',' ','*',' ','*',' ','*',' ','*',' ','*',' ','*','*',' ',' ','*','*',' ','*',' ','*',' ','*',' ','*',' ','*',' ','*','*','*','*',' ','*'},
 {'*','>',' ',' ',' ',' ',' ',' ',' ','*',' ',' ',' ','*',' ',' ',' ','*',' ',' ',' ',' ','*',' ',' ',' ','*',' ',' ',' ','*',' ',' ',' ',' ',' ',' ',' ','^','*'},
 {'*','*','*','*','*','*','*','*','*','*','*','*','*','*','*','*','*','*','*','*','*','*','*','*','*','*','*','*','*','*','*','*','*','*','*','*','*','*','*','*'}};
